
11111111111111111111
10000001000001000001
10000001000001000001
10000001000001000001
10000001000001000001
10000001000001000001
10000001111111111111
10000001001000000001
11111111001000000001
10000001001000000001
10000001001000000001
11111111111111111001
10000001000000001001
10011111000000001001
10011111000000001001
10011111000000001001
10000001000000001001
11111111111111111001
10000001000000000001
11111111111111111111
